########################################
#..................##..................#
#..................##..................#
#...........#..##########..#...........#
#...........#......##......#...........#
#...........#..##..##..##..#...........#
#...........#..............#...........#
#..################.#################..#
#.................#..#.................#
###...............#..#...............###
#.......###.......##.#.......###.......#
#....#########....#.......#########....#
#....#########.......#....#########....#
#.......###.......#.##.......###.......#
#...............###..###...............#
#.................#..#.................#
################..##.#..################
###...........##........##...........###
###...........##........##...........###
#........##........##........##........#
#........##........##........##........#
###...........##........##...........###
###...........##........##...........###
################..#.##..################
#.................#..#.................#
#...............###..###...............#
#.......###.......##.#.......###.......#
#....#########.......#....#########....#
#....#########....#.......#########....#
#.......###.......#.##.......###.......#
###...............#..#...............###
#.................#..#.................#
#..#################.################..#
#...........#..............#...........#
#...........#..##..##..##..#...........#
#...........#......##......#...........#
#...........#..##########..#...........#
#..................##..................#
#..................##..................#
########################################