########################################
#........#.........##.........#........#
#........#.........##.........#........#
#........#.........##.........#........#
#..................##..................#
#..................##..................#
#..#######....############....#######..#
#......................................#
#......................................#
#......................................#
#......................................#
#......................................#
#......................................#
#......................................#
###########........##........###########
#..................##..................#
#..................##..................#
#..................##..................#
#..................##..................#
#....#####....############....#####....#
#....#####....############....#####....#
#..................##..................#
#..................##..................#
#..................##..................#
#..................##..................#
###########........##........###########
#......................................#
#......................................#
#......................................#
#......................................#
#......................................#
#......................................#
#......................................#
#..#######....############....#######..#
#..................##..................#
#..................##..................#
#........#.........##.........#........#
#........#.........##.........#........#
#........#.........##.........#........#
########################################